26 8
##########################
#1                       #
# #####  ###  #  # #   # #
#   #   #   # ## #  # #  #
#   #   #   # # ##   #   #
#   #    ###  #  #   #   #
#                       2#
##########################
